11111111111111111111111111111111
10000000000000000000000000000001
10000000000000000000000000000001
10000000000000000000000000000001
10000000000000000000000000000001
10000000000000000000000000000001
10000000000000000000000000000001
10000000000000000000000000000001
10000000000001111110000000000001
10000000000000000010000000000001
10000000000000000010000000000001
10000000000000000010000000000001
10000000000000000000000000000001
10000000000000000000000000000001
10000000000000000000000000000001
10000000000000000000000000000001
10000000000000000000000000000001
10000000000000000000000000111111
10000000000000000000011100000001
10000000000000000000000000000001
10000000000000001110000000000001
10000000000011100000000000000001
1P000000111100000000000000000001
11111111111111111111111111111111